04000000000000000000-
04044400000000000000-
04040400000000000000-
04040400000000000000-
04040400000000000000-
04040400000000000000-
04440400000000000000-
00000000000000000000